WWLLWW
WWLLWW
WWLLWW  WWWWWWWW
WWLLWW  WWWWWWWW
WWLLWWWWWWAAAAWW
WWLLLLLLLLAAAAWW
WWLLLLLLLLAAAAWW
WWWWWWWWWWAAAAWW
        WWWWWWWW
        WWWWWWWW