WWWWWWWWWWWWWWWWWWWWWWWWWWWWWWWWWWWWWWWWWWWWWWWWWWWWWWWWWWWWWWWWWWWWWWW
WWWWWWWWWWWWWWWWWWWWWWWWWWWWWWWWWWWWWWWWWWWWWWWWWWWWWWWWWWWWWWWWWWWWWWW
WWRRWWWWWWWWWWWWWWWWWWWWWWWWWWWWWWWWWWWWWWWWWWWWWWWWWWWWWWWWWWWWWWWWWWW
WWLLWWWWWWWWWWWWWWWWWWWWWWWWWWWWWWWWWWWWWWWWWWWWWWWWWWWWWWWWWWWWWWWWWWW
WWLLWWWWWWSSSSWWWWWWWWWWAAAAAAAAWWWWWWWWLLLLSLLLLRLLLLALLLLLAALLLWWWWWW
WWLLLLLLLLLLLLLLLLLRLLLLLLLLLLLLLLLLRLLLLLLLSLLLLSLLLLALLLLLAALLLLLLLWW
WWLLLLLLLLLLLLLLLLLRLLLLLLLLLLLLLLLLRLLLLLLLSLLLLSLLLLALLLLLAALLLLLLLWW
WWWWWWWWWWSSSSWWWWWWWWWWAAAAAAAAWWWWWWWWLLLLSLLLLRLLLLALLLLLAALLLLLLLWW
WWWWWWWWWWWWWWWWWWWWWWWWWWWWWWWWWWWWWWWWWWWWWWWWWWWWWWWWWWWWWWWWWWWLLWW
WWWWWWWWWWWWWWWWWWWWWWWWWWWWWWWWWWWWWWWWWWWWWWWWWWWWWWWWWWWWWWWWWWWLLWW
WWWWWWWWWWWWWWWWWWWWWWWWWWSSSSSSSWWWWWWWWWWWAAAALAALLAALLAALLWWLSLLLRWW
WWWWWWWWWWWWWWWWWWWWWWWWWWSRLSSLSSWWWWWWWWWWLLAAAAAAAAAAAAALLWWLLSLLRWW
WWWWWWWWWWWWWWWWWWWWWWWWWWSSSSSLSSSLLSLLSLLRLLAAALLAAAALLAALLAASSWWWWWW
WWWWWWWWWWWWWWWWWWWWWWWWWWSSSSLLSSSSSSWWWWWWLLAAAAAAAAAAAAALLAASSWWWWWW
WWWWWWWWWWWWWWWWWWWWWWWWWWLLWSLSSLSLLSWWWWWWAAAALAALLAALLAALLLLLLWWWWWW
WWWWWWWWWWWWWWWWWWWWWWWWWWLLWSLLLLSSSSWWWWWWWWWWWWWWWWWWWWWWWWWWWWWWWWW
                     WWWWWLRWWWWWWWWWWWWWWWWWWWWWWWWWWWWWWWWWWWWWWWWWWW
                     WAAAALLLAAAAWWWWWWWWWWWWWWWWWWWWWWWWWLLLLLWWWWWWWW
                     WAAAALLLAAAAWWWWWWWWWWWWWWWWWWWWWWWWWLLLLLWWWWWWWW
                     WAAAAAAAAAAAWWWWWWWWWWWWWWWWWWWWWWWWWLLLLLWWWWWWWW
                     WAAAAAAAAAAAWWWWWWWWWWWWWWWWWWWSSSWWWWWSWWWWWWWWWW
                     WAAALAAALAAAAAAAAAAAAAARAAARAASSRSWWWWWSWWWWWWWWWW
                     WAAALAAALAAAAAAAAAAAAAAAAAAAAASSSSWWWWWSWWWWWWWWWW
                     WAAAAAAAAAAAAAAAAAAAARAAARAAARSSSWWWWWWLWWWWWWWWWW
                     WAAAAAAAAAAAAAAAAAAALAAWWWWWWWWWLWWWWWWLWWWWWWWWWW
                     WLLLAAAAALLLAAAAAAALAAAWWWWWWWWWSSSSSSSRSSWWWWWWWW
                     WAAAAAAAAAAAAAAAAALAAAAWWWWWWWWWSSSSSSSSSSWWWWWWWW
                     WAAAAALAAAAAAAAAALAAAAAWWWWWWWWWSLSSSSSSLSWWWWWWWW
                     WAAAALLLAAAAAAAALAAAAAAWWWWWWWWWSSSSSRSSSSWWWWWWWW
                     WAAALLRLLAAAAAALAAAAAAAWWWWWWWWWSSLSSSSSSSWWWWWWWW
                     WAAALLLLLLLLAALAAAAAAAAWWWWWWWWWSSSSSSSSSSWWWWWWWW
                     WWWWWWWWWWWWWWWWWWWWWWWWWWWWWWWWWWWWWWWWWWWWWWWWWW